"filename", "language", "XML", "Batch", "Java", "comment", "blank", "total"
"c:\Users\ASUS\VSCode\MyCodes\algotradingbot\pom.xml", "XML", 87, 0, 0, 2, 15, 104
"c:\Users\ASUS\VSCode\MyCodes\algotradingbot\run.bat", "Batch", 0, 3, 0, 0, 1, 4
"c:\Users\ASUS\VSCode\MyCodes\algotradingbot\src\main\java\com\algotradingbot\App.java", "Java", 0, 0, 9, 3, 5, 17
"c:\Users\ASUS\VSCode\MyCodes\algotradingbot\src\main\java\com\algotradingbot\chart\AnnotationUtils.java", "Java", 0, 0, 122, 21, 34, 177
"c:\Users\ASUS\VSCode\MyCodes\algotradingbot\src\main\java\com\algotradingbot\chart\CandleChart.java", "Java", 0, 0, 166, 2, 38, 206
"c:\Users\ASUS\VSCode\MyCodes\algotradingbot\src\main\java\com\algotradingbot\chart\ChartBuilder.java", "Java", 0, 0, 67, 1, 26, 94
"c:\Users\ASUS\VSCode\MyCodes\algotradingbot\src\main\java\com\algotradingbot\chart\DatasetFactory.java", "Java", 0, 0, 138, 0, 20, 158
"c:\Users\ASUS\VSCode\MyCodes\algotradingbot\src\main\java\com\algotradingbot\chart\PlotFactory.java", "Java", 0, 0, 130, 4, 33, 167
"c:\Users\ASUS\VSCode\MyCodes\algotradingbot\src\main\java\com\algotradingbot\chart\RendererFactory.java", "Java", 0, 0, 38, 0, 9, 47
"c:\Users\ASUS\VSCode\MyCodes\algotradingbot\src\main\java\com\algotradingbot\core\Candle.java", "Java", 0, 0, 61, 0, 17, 78
"c:\Users\ASUS\VSCode\MyCodes\algotradingbot\src\main\java\com\algotradingbot\core\Performance.java", "Java", 0, 0, 36, 2, 10, 48
"c:\Users\ASUS\VSCode\MyCodes\algotradingbot\src\main\java\com\algotradingbot\core\Signal.java", "Java", 0, 0, 85, 3, 20, 108
"c:\Users\ASUS\VSCode\MyCodes\algotradingbot\src\main\java\com\algotradingbot\core\StrategyPerformance.java", "Java", 0, 0, 37, 0, 12, 49
"c:\Users\ASUS\VSCode\MyCodes\algotradingbot\src\main\java\com\algotradingbot\core\TradingStrategy.java", "Java", 0, 0, 81, 5, 25, 111
"c:\Users\ASUS\VSCode\MyCodes\algotradingbot\src\main\java\com\algotradingbot\engine\CandlesEngine.java", "Java", 0, 0, 77, 1, 17, 95
"c:\Users\ASUS\VSCode\MyCodes\algotradingbot\src\main\java\com\algotradingbot\engine\PeriodTester.java", "Java", 0, 0, 129, 14, 40, 183
"c:\Users\ASUS\VSCode\MyCodes\algotradingbot\src\main\java\com\algotradingbot\engine\getDataFromBinance.java", "Java", 0, 0, 66, 1, 20, 87
"c:\Users\ASUS\VSCode\MyCodes\algotradingbot\src\main\java\com\algotradingbot\strategies\OldInsideBarStrategy.java", "Java", 0, 0, 57, 0, 19, 76
"c:\Users\ASUS\VSCode\MyCodes\algotradingbot\src\main\java\com\algotradingbot\strategies\TrendRSIBBBand.java", "Java", 0, 0, 156, 10, 48, 214
"c:\Users\ASUS\VSCode\MyCodes\algotradingbot\src\main\java\com\algotradingbot\utils\BollingerBands.java", "Java", 0, 0, 11, 0, 4, 15
"c:\Users\ASUS\VSCode\MyCodes\algotradingbot\src\main\java\com\algotradingbot\utils\CandleUtils.java", "Java", 0, 0, 159, 11, 45, 215
"c:\Users\ASUS\VSCode\MyCodes\algotradingbot\src\main\java\com\algotradingbot\utils\FilterRejectionTracker.java", "Java", 0, 0, 85, 7, 20, 112
"c:\Users\ASUS\VSCode\MyCodes\algotradingbot\src\main\java\com\algotradingbot\utils\TFtrendAnalyzer.java", "Java", 0, 0, 47, 0, 14, 61
"c:\Users\ASUS\VSCode\MyCodes\algotradingbot\src\main\java\com\algotradingbot\utils\TimeUtils.java", "Java", 0, 0, 28, 0, 11, 39
"c:\Users\ASUS\VSCode\MyCodes\algotradingbot\src\main\java\com\algotradingbot\utils\TrendUtils.java", "Java", 0, 0, 296, 9, 82, 387
"c:\Users\ASUS\VSCode\MyCodes\algotradingbot\src\test\java\com\algotradingbot\AppTest.java", "Java", 0, 0, 11, 6, 4, 21
"Total", "-", 87, 3, 2092, 102, 589, 2873