"filename", "language", "Java", "comment", "blank", "total"
"c:\Users\ASUS\VSCode\MyCodes\algotradingbot\src\main\java\com\algotradingbot\App.java", "Java", -1, 1, 0, 0
"c:\Users\ASUS\VSCode\MyCodes\algotradingbot\src\main\java\com\algotradingbot\chart\CandleChart.java", "Java", 4, 0, 1, 5
"c:\Users\ASUS\VSCode\MyCodes\algotradingbot\src\main\java\com\algotradingbot\chart\StrategyChartUtils.java", "Java", 7, 4, 4, 15
"c:\Users\ASUS\VSCode\MyCodes\algotradingbot\src\main\java\com\algotradingbot\core\TradingStrategy.java", "Java", 32, 3, 12, 47
"c:\Users\ASUS\VSCode\MyCodes\algotradingbot\src\main\java\com\algotradingbot\engine\GetDataFromInteractiveBroker.java", "Java", 96, 26, 23, 145
"c:\Users\ASUS\VSCode\MyCodes\algotradingbot\src\main\java\com\algotradingbot\engine\PeriodTesterBinance.java", "Java", 1, 0, 3, 4
"c:\Users\ASUS\VSCode\MyCodes\algotradingbot\src\main\java\com\algotradingbot\engine\PeriodTesterInteractiveBroker.java", "Java", 7, 0, 9, 16
"c:\Users\ASUS\VSCode\MyCodes\algotradingbot\src\main\java\com\algotradingbot\strategies\MWPatternStrategy.java", "Java", 43, 1, 12, 56
"c:\Users\ASUS\VSCode\MyCodes\algotradingbot\src\main\java\com\algotradingbot\strategies\TrendRSIBBBand.java", "Java", 16, 1, 3, 20
"c:\Users\ASUS\VSCode\MyCodes\algotradingbot\src\main\java\com\algotradingbot\utils\MPattern.java", "Java", 98, 12, 32, 142
"c:\Users\ASUS\VSCode\MyCodes\algotradingbot\src\main\java\com\algotradingbot\utils\TimeUtils.java", "Java", 19, 2, 2, 23
"Total", "-", 322, 50, 101, 473