"filename", "language", "XML", "Java", "Batch", "comment", "blank", "total"
"c:\Users\ASUS\VSCode\MyCodes\algotradingbot\pom.xml", "XML", 92, 0, 0, 2, 14, 108
"c:\Users\ASUS\VSCode\MyCodes\algotradingbot\run.bat", "Batch", 0, 0, 3, 0, 1, 4
"c:\Users\ASUS\VSCode\MyCodes\algotradingbot\src\main\java\com\algotradingbot\App.java", "Java", 0, 26, 0, 3, 12, 41
"c:\Users\ASUS\VSCode\MyCodes\algotradingbot\src\main\java\com\algotradingbot\chart\AnnotationUtils.java", "Java", 0, 156, 0, 21, 37, 214
"c:\Users\ASUS\VSCode\MyCodes\algotradingbot\src\main\java\com\algotradingbot\chart\CandleChart.java", "Java", 0, 184, 0, 6, 35, 225
"c:\Users\ASUS\VSCode\MyCodes\algotradingbot\src\main\java\com\algotradingbot\chart\ChartBuilder.java", "Java", 0, 67, 0, 1, 27, 95
"c:\Users\ASUS\VSCode\MyCodes\algotradingbot\src\main\java\com\algotradingbot\chart\DatasetFactory.java", "Java", 0, 138, 0, 0, 20, 158
"c:\Users\ASUS\VSCode\MyCodes\algotradingbot\src\main\java\com\algotradingbot\chart\PlotFactory.java", "Java", 0, 130, 0, 4, 33, 167
"c:\Users\ASUS\VSCode\MyCodes\algotradingbot\src\main\java\com\algotradingbot\chart\RendererFactory.java", "Java", 0, 38, 0, 0, 9, 47
"c:\Users\ASUS\VSCode\MyCodes\algotradingbot\src\main\java\com\algotradingbot\chart\StrategyChartUtils.java", "Java", 0, 35, 0, 14, 17, 66
"c:\Users\ASUS\VSCode\MyCodes\algotradingbot\src\main\java\com\algotradingbot\core\BrokerBinanceManager.java", "Java", 0, 15, 0, 1, 7, 23
"c:\Users\ASUS\VSCode\MyCodes\algotradingbot\src\main\java\com\algotradingbot\core\Candle.java", "Java", 0, 85, 0, 7, 22, 114
"c:\Users\ASUS\VSCode\MyCodes\algotradingbot\src\main\java\com\algotradingbot\core\Performance.java", "Java", 0, 36, 0, 2, 10, 48
"c:\Users\ASUS\VSCode\MyCodes\algotradingbot\src\main\java\com\algotradingbot\core\RollingWindow.java", "Java", 0, 29, 0, 0, 10, 39
"c:\Users\ASUS\VSCode\MyCodes\algotradingbot\src\main\java\com\algotradingbot\core\Signal.java", "Java", 0, 85, 0, 3, 20, 108
"c:\Users\ASUS\VSCode\MyCodes\algotradingbot\src\main\java\com\algotradingbot\core\StrategyPerformance.java", "Java", 0, 37, 0, 0, 12, 49
"c:\Users\ASUS\VSCode\MyCodes\algotradingbot\src\main\java\com\algotradingbot\core\TradingStrategy.java", "Java", 0, 124, 0, 5, 46, 175
"c:\Users\ASUS\VSCode\MyCodes\algotradingbot\src\main\java\com\algotradingbot\engine\CandlesEngine.java", "Java", 0, 77, 0, 1, 17, 95
"c:\Users\ASUS\VSCode\MyCodes\algotradingbot\src\main\java\com\algotradingbot\engine\DemoBrokerBinanceManager.java", "Java", 0, 30, 0, 0, 9, 39
"c:\Users\ASUS\VSCode\MyCodes\algotradingbot\src\main\java\com\algotradingbot\engine\GetDataFromInteractiveBroker.java", "Java", 0, 519, 0, 82, 118, 719
"c:\Users\ASUS\VSCode\MyCodes\algotradingbot\src\main\java\com\algotradingbot\engine\PeriodTesterBinance.java", "Java", 0, 136, 0, 34, 43, 213
"c:\Users\ASUS\VSCode\MyCodes\algotradingbot\src\main\java\com\algotradingbot\engine\PeriodTesterInteractiveBroker.java", "Java", 0, 43, 0, 1, 15, 59
"c:\Users\ASUS\VSCode\MyCodes\algotradingbot\src\main\java\com\algotradingbot\engine\getDataFromBinance.java", "Java", 0, 66, 0, 1, 20, 87
"c:\Users\ASUS\VSCode\MyCodes\algotradingbot\src\main\java\com\algotradingbot\strategies\BBbandWithComma.java", "Java", 0, 64, 0, 8, 22, 94
"c:\Users\ASUS\VSCode\MyCodes\algotradingbot\src\main\java\com\algotradingbot\strategies\ExecuteDemoBBbandWithComma.java", "Java", 0, 39, 0, 5, 13, 57
"c:\Users\ASUS\VSCode\MyCodes\algotradingbot\src\main\java\com\algotradingbot\strategies\OldInsideBarStrategy.java", "Java", 0, 55, 0, 22, 17, 94
"c:\Users\ASUS\VSCode\MyCodes\algotradingbot\src\main\java\com\algotradingbot\strategies\TrendRSIBBBand.java", "Java", 0, 141, 0, 10, 43, 194
"c:\Users\ASUS\VSCode\MyCodes\algotradingbot\src\main\java\com\algotradingbot\utils\BollingerBands.java", "Java", 0, 34, 0, 0, 11, 45
"c:\Users\ASUS\VSCode\MyCodes\algotradingbot\src\main\java\com\algotradingbot\utils\CandleUtils.java", "Java", 0, 197, 0, 16, 53, 266
"c:\Users\ASUS\VSCode\MyCodes\algotradingbot\src\main\java\com\algotradingbot\utils\FilterRejectionTracker.java", "Java", 0, 85, 0, 7, 20, 112
"c:\Users\ASUS\VSCode\MyCodes\algotradingbot\src\main\java\com\algotradingbot\utils\TFtrendAnalyzer.java", "Java", 0, 47, 0, 0, 14, 61
"c:\Users\ASUS\VSCode\MyCodes\algotradingbot\src\main\java\com\algotradingbot\utils\TimeUtils.java", "Java", 0, 114, 0, 29, 26, 169
"c:\Users\ASUS\VSCode\MyCodes\algotradingbot\src\main\java\com\algotradingbot\utils\TrendUtils.java", "Java", 0, 467, 0, 12, 126, 605
"c:\Users\ASUS\VSCode\MyCodes\algotradingbot\src\test\java\com\algotradingbot\AppTest.java", "Java", 0, 11, 0, 6, 4, 21
"Total", "-", 92, 3310, 3, 303, 903, 4611