"filename", "language", "Batch", "XML", "Java", "comment", "blank", "total"
"c:\Users\ASUS\VSCode\MyCodes\algotradingbot\pom.xml", "XML", 0, 92, 0, 2, 14, 108
"c:\Users\ASUS\VSCode\MyCodes\algotradingbot\run.bat", "Batch", 3, 0, 0, 0, 1, 4
"c:\Users\ASUS\VSCode\MyCodes\algotradingbot\src\main\java\com\algotradingbot\App.java", "Java", 0, 0, 25, 19, 16, 60
"c:\Users\ASUS\VSCode\MyCodes\algotradingbot\src\main\java\com\algotradingbot\chart\AnnotationUtils.java", "Java", 0, 0, 156, 21, 37, 214
"c:\Users\ASUS\VSCode\MyCodes\algotradingbot\src\main\java\com\algotradingbot\chart\CandleChart.java", "Java", 0, 0, 188, 6, 36, 230
"c:\Users\ASUS\VSCode\MyCodes\algotradingbot\src\main\java\com\algotradingbot\chart\ChartBuilder.java", "Java", 0, 0, 67, 1, 27, 95
"c:\Users\ASUS\VSCode\MyCodes\algotradingbot\src\main\java\com\algotradingbot\chart\DatasetFactory.java", "Java", 0, 0, 138, 0, 20, 158
"c:\Users\ASUS\VSCode\MyCodes\algotradingbot\src\main\java\com\algotradingbot\chart\PlotFactory.java", "Java", 0, 0, 130, 4, 33, 167
"c:\Users\ASUS\VSCode\MyCodes\algotradingbot\src\main\java\com\algotradingbot\chart\RendererFactory.java", "Java", 0, 0, 38, 0, 9, 47
"c:\Users\ASUS\VSCode\MyCodes\algotradingbot\src\main\java\com\algotradingbot\chart\StrategyChartUtils.java", "Java", 0, 0, 42, 18, 21, 81
"c:\Users\ASUS\VSCode\MyCodes\algotradingbot\src\main\java\com\algotradingbot\core\BrokerBinanceManager.java", "Java", 0, 0, 15, 1, 7, 23
"c:\Users\ASUS\VSCode\MyCodes\algotradingbot\src\main\java\com\algotradingbot\core\Candle.java", "Java", 0, 0, 85, 7, 22, 114
"c:\Users\ASUS\VSCode\MyCodes\algotradingbot\src\main\java\com\algotradingbot\core\Performance.java", "Java", 0, 0, 36, 2, 10, 48
"c:\Users\ASUS\VSCode\MyCodes\algotradingbot\src\main\java\com\algotradingbot\core\RollingWindow.java", "Java", 0, 0, 29, 0, 10, 39
"c:\Users\ASUS\VSCode\MyCodes\algotradingbot\src\main\java\com\algotradingbot\core\Signal.java", "Java", 0, 0, 85, 3, 20, 108
"c:\Users\ASUS\VSCode\MyCodes\algotradingbot\src\main\java\com\algotradingbot\core\StrategyPerformance.java", "Java", 0, 0, 37, 0, 12, 49
"c:\Users\ASUS\VSCode\MyCodes\algotradingbot\src\main\java\com\algotradingbot\core\TradingStrategy.java", "Java", 0, 0, 232, 22, 81, 335
"c:\Users\ASUS\VSCode\MyCodes\algotradingbot\src\main\java\com\algotradingbot\engine\CandlesEngine.java", "Java", 0, 0, 77, 1, 17, 95
"c:\Users\ASUS\VSCode\MyCodes\algotradingbot\src\main\java\com\algotradingbot\engine\DemoBrokerBinanceManager.java", "Java", 0, 0, 30, 0, 9, 39
"c:\Users\ASUS\VSCode\MyCodes\algotradingbot\src\main\java\com\algotradingbot\engine\GetDataFromBinance.java", "Java", 0, 0, 66, 1, 20, 87
"c:\Users\ASUS\VSCode\MyCodes\algotradingbot\src\main\java\com\algotradingbot\engine\GetDataFromInteractiveBroker.java", "Java", 0, 0, 623, 113, 146, 882
"c:\Users\ASUS\VSCode\MyCodes\algotradingbot\src\main\java\com\algotradingbot\engine\PeriodTesterBinance.java", "Java", 0, 0, 146, 43, 45, 234
"c:\Users\ASUS\VSCode\MyCodes\algotradingbot\src\main\java\com\algotradingbot\engine\PeriodTesterInteractiveBroker.java", "Java", 0, 0, 82, 4, 37, 123
"c:\Users\ASUS\VSCode\MyCodes\algotradingbot\src\main\java\com\algotradingbot\strategies\BBbandWithComma.java", "Java", 0, 0, 63, 8, 22, 93
"c:\Users\ASUS\VSCode\MyCodes\algotradingbot\src\main\java\com\algotradingbot\strategies\CommaFlag.java", "Java", 0, 0, 37, 0, 13, 50
"c:\Users\ASUS\VSCode\MyCodes\algotradingbot\src\main\java\com\algotradingbot\strategies\ExecuteDemoBBbandWithComma.java", "Java", 0, 0, 39, 5, 13, 57
"c:\Users\ASUS\VSCode\MyCodes\algotradingbot\src\main\java\com\algotradingbot\strategies\MWPatternStrategyEURUSD1H.java", "Java", 0, 0, 60, 4, 17, 81
"c:\Users\ASUS\VSCode\MyCodes\algotradingbot\src\main\java\com\algotradingbot\strategies\MWPatternTest.java", "Java", 0, 0, 62, 6, 14, 82
"c:\Users\ASUS\VSCode\MyCodes\algotradingbot\src\main\java\com\algotradingbot\strategies\OldInsideBarStrategy.java", "Java", 0, 0, 55, 22, 17, 94
"c:\Users\ASUS\VSCode\MyCodes\algotradingbot\src\main\java\com\algotradingbot\strategies\TrendRSIBBBand.java", "Java", 0, 0, 156, 11, 46, 213
"c:\Users\ASUS\VSCode\MyCodes\algotradingbot\src\main\java\com\algotradingbot\utils\BollingerBands.java", "Java", 0, 0, 20, 0, 8, 28
"c:\Users\ASUS\VSCode\MyCodes\algotradingbot\src\main\java\com\algotradingbot\utils\CandleUtils.java", "Java", 0, 0, 197, 16, 53, 266
"c:\Users\ASUS\VSCode\MyCodes\algotradingbot\src\main\java\com\algotradingbot\utils\FilterRejectionTracker.java", "Java", 0, 0, 85, 7, 20, 112
"c:\Users\ASUS\VSCode\MyCodes\algotradingbot\src\main\java\com\algotradingbot\utils\Instrument.java", "Java", 0, 0, 39, 8, 7, 54
"c:\Users\ASUS\VSCode\MyCodes\algotradingbot\src\main\java\com\algotradingbot\utils\MPatternEURUSD1H.java", "Java", 0, 0, 71, 30, 28, 129
"c:\Users\ASUS\VSCode\MyCodes\algotradingbot\src\main\java\com\algotradingbot\utils\MPatternTest.java", "Java", 0, 0, 71, 6, 24, 101
"c:\Users\ASUS\VSCode\MyCodes\algotradingbot\src\main\java\com\algotradingbot\utils\TFtrendAnalyzer.java", "Java", 0, 0, 47, 0, 14, 61
"c:\Users\ASUS\VSCode\MyCodes\algotradingbot\src\main\java\com\algotradingbot\utils\TimeUtils.java", "Java", 0, 0, 133, 31, 28, 192
"c:\Users\ASUS\VSCode\MyCodes\algotradingbot\src\main\java\com\algotradingbot\utils\TrendUtils.java", "Java", 0, 0, 498, 12, 134, 644
"c:\Users\ASUS\VSCode\MyCodes\algotradingbot\src\main\java\com\algotradingbot\utils\WPatternEURUSD1H.java", "Java", 0, 0, 75, 37, 25, 137
"c:\Users\ASUS\VSCode\MyCodes\algotradingbot\src\main\java\com\algotradingbot\utils\WPatternTest.java", "Java", 0, 0, 75, 11, 24, 110
"c:\Users\ASUS\VSCode\MyCodes\algotradingbot\src\test\java\com\algotradingbot\AppTest.java", "Java", 0, 0, 11, 6, 4, 21
"Total", "-", 3, 92, 4121, 488, 1161, 5865